  C     65,  105,   125
	WE ./textures/west.xpm
 NO ./textures/north.xpm
  SO   ./textures/south.xpm
EA ./textures/east.xpm
  F 128, 128, 129

11111111111111111111111111111111111111111111111111111
11110000001110000000010000001111111111100000000000001
10000000000000001111110000001000000000100000000000001
11110000000000000000000000001000000000100000000001111
11110000000000000000000000001000000000100000000000011
11000000000000011111111111111000000000000000000011111
11111100000000000000000000000000000000000000000000W01
11000000000000011111111111111000000000000000000011111
11110000000000000000000000001000000000100000000000011
11110000000000000000000000001000000000100000000001111
10000000000000001111110000001000000000100000000001111
11110000001110000000001000001000000000100000000000001
11111111111111111111111111111111111111111111111111111
