	
 C     65,  105,   125
	WE ./textures/west.xpm
 NO ./textures/north.xpm
  SO   ./textures/south.xpm
EA ./textures/east.xpm
  F 128, 128, 129

11111111111111111111
10001N10000000000001		111
11111111111111111111        101
111111111111111111111111111111111    
									1
									1
									1
									1
									1
